++#s#++++
+##+#+##+
++++#+#++
+####+###
+++++++++
####+###+
+++#+#+++
+#+#+#+##
+#+++#+++
+#######+
++#++++++
####e####
