#####################################
##s###+++++++++###+++++###+###+++++##
##+###+#######+###+###+###+###+###+##
##+++++###+++++###+###+++++###+###+##
####+#####+#######+###+###+###+###+++
##+#+++###+++++###+###+###+++++###+##
##+###+#######+###+###+###########+##
##+###++++++##+++++###+++++++++++++##
##+###################+##############
##+++++++++++++++++###+++++###+++++##
##+###############+#######+###+###+##
##+++++###+++++e##+++++++++###+###+##
######+###+#######################+##
##+++++###+++++++++++++###+++++++++##
##+###############+###+#######+###+##
##+++++++++++++###+###+###+++++###+##
##############+###+###+###+#######+##
#++++++++++++++++++###+++++##++++++##
#####################################
