#####################################################################################################
s+#+++++++#+++++++++++++++++#+++++++++++++#+++++++++#+++++++++++++++++++++++++#+++++++++++++#+++++++#
#+#####+#+#######+###########+#####+#####+#+###+#####+#############+#####+#+###+#########+###+#####+#
#+#+++++#+++++++#+#+++++++++++#+++#+++#+++#+#+++#+++++#+++++#+++++#+#+++#+#+#+++#+++++++#+#+++#+++++#
#+#+###########+#+#+###########+#+#####+###+#+###+#####+###+#+###+###+#+###+#+###+#####+#+#+###+###+#
#+#+++++++++++#+#+++++#+++++++++#+++++#+++++#+++++#+++++#+#+#+++#+++++#+#+++#+++#+++#+++#+++#+++#+++#
#+###########+#+#######+#############+#+###########+#####+#+###+#######+#+#+#+#####+#+###+###+#######
#+#+++++++++++#+++#+++#+++#+++#+++++++#+#+++++++++++#+++++++#+++#+++#+++++#+#+#+++++#+++#+++#+++++++#
#+#+#############+#+#+###+###+#+#######+#+###########+#######+###+#+#########+#+#######+###########+#
#+#+++#+++++#+++++++#+++++#+++#+++++#+++#+++#+++++++#+++#+++#+++++#+++#+++++++#+++++#+++++++++++++++#
#+#+#+###+###+#############+#######+#######+#+###+#####+###+#+#######+#+###########+###########+#####
#+#+#+++#+++++++#+++#+++++#+++++++#+#+++++++#+#+#+#+++#+#+++#+#+++#+++#+#+++#+++++#+++#+++++++#+#+++#
#+#####+#########+#+#+###+#####+###+#+#######+#+#+#+#+#+#+###+###+#+#+#+#+#+#+###+#+#+#+#####+###+#+#
#+++#+++#+++++++#+#+++#+++#+++++#+++#+++#+++++#+++#+#+++#+#+++++++#+#+#+#+#+++#+#+#+#+++#+++#+#+++#+#
###+#+###+#####+#+#####+###+#####+#####+#+#####+###+#####+#+#####+#+###+#+#####+#+#####+###+#+#+###+#
#+#+#+++++++++#+++++++#+#+++#+++++#+++++#+++#+++++#+++#+++++#+++#+#+#+++#+++++#+++++++#+++++#+++#+++#
#+#+#+#######+#####+###+###+#+#####+#######+#########+#######+#+###+#+#######+#######+###+#####+#+#+#
#+++#+#+++#+++#+++#+#+++#+++#+++#+++#+++++#+++++++++++++++++#+#+++++#+#+++++++#+++++#+++#+#+++#+#+#+#
#+#####+#+#####+#+###+###+#####+###+#+###+#################+#+#######+#+#######+###+###+###+#+###+#+#
#+++++++#+++++++#+#+++#+++++++#+++#+++++#+++++++++++#+#+++#+#+++++++++#+++++++#+++#+++#+++++#+++++#+#
#################+#+#######+#+###+#####+###########+#+#+#+#+#+###############+#+#####+#+#############
#+++#+++++++++++#+++#+++++++#+++#+++++#+++#+++++++++#+++#+#+#+++++#+++++++++++#+#+++++#+#+++++++++++#
###+#+#########+#####+#########+#####+#+###+#############+#+#####+#+###+#######+#+#######+#########+#
#+++#+#+++++++#+++++++#+++#+++++#+++++#+#+++#+++++++++++++#+++++#+#+#+++#+++++++#+++#+++++#+++++++++#
#+#+#+#####+#####+#####+#+#+#####+#####+#+###+#####+###########+###+#####+#########+#+#####+#######+#
#+#+#+++++#+#+++#+++++++#+#+#+++#+#+++#+#+++#+++++#+#+++++#+++#+++#+++++#+#+++++++++#+#+++++#+++#+++#
#+#######+#+#+#+#####+###+#+#+###+###+#+###+#####+###+###+#+#+###+#####+#+#+#########+#+#####+#+#####
#+++++++#+#+#+#+++++#+#+++#+++#+++#+++#+++#+++++#+++#+#+#+++#+++#+#+++++#+#+#+++++++++#+++#+++#+++++#
#######+#+#+#+#####+###+###+###+###+#####+#####+###+#+#+#######+#+#+#####+#+#+###########+#+#######+#
#+++++++#+++#+++++#+#+++#+#+#+++#+#+++++#+++++#+++#+#+++++++#+++#+#+#+++++#+++#+#+++++++#+++#+++++#+#
#+#######+#######+#+#+###+#+#+###+#+#+#####+#####+#+###+#####+###+#+#+#######+#+#+#####+#####+###+#+#
#+++++++++#+++++++#+++#+++++#+#+++#+#+++++++#+++++#+++#+#+++++#+++++#+#+++++#+#+++#+++++#+++++#+#+#+#
#+#####+###+#+###############+#+#+#+#########+#####+#+#+#+###+#+#####+#+###+#+#####+#####+#####+#+#+#
#+#+++#+#+++#+#+++++++++++++++#+#+++++++#+++++#+++#+#+++#+++#+#+#+#+++#+#+++#+++++++#+++++#+++++#+++#
#+#+#+###+###+#+#########################+#+###+#+#######+#+###+#+#+###+###+#########+#####+#+#####+#
#+#+#+++++#+++#+++++#+++++++++++++++++++#+#+#+++#+++++++#+#+#+++#+#+#+#+++#+++#+++++++#+++++#+++++#+#
#+#+#########+#####+#####+#############+#+###+#######+#+#+#+#+###+#+#+###+###+#+#######+#########+#+#
#+#+++#+++++#+#+++++#+++++#+++++#+++#+++#+++++#+++++#+#+#+#+++++++#+#+++#+++#+#+++++#+#+++#+++++#+++#
#####+#+###+###+#####+#####+#####+#+#+#########+###+#+#+#########+#+#+#+###+#+#####+#+###+#####+#####
#+++++#+++#+++#+++#+++++#+#+++++++#+++#+++++++++#+#+#+#+++++++++#+#+#+#+#+++#+++++++#+++++#+++++++++#
#+#####+#####+###+#####+#+#+###########+#########+#+#+#########+###+###+#+#####+#######+###+###+#####
#+++++++#+++#+++#+++++++#+++#+++++#+++#+++++++++#+#+#+#+++++++++#+++#+++#+++#+++#+++++#+++#+++#+#+++#
#+#######+#+###+#########+###+#####+#+#+#######+#+#+###+#####+###+###+#####+#+###+###+###+###+###+#+#
#+++++++#+#+++++++++#+++#+#+++#+++++#+++#+++++++#+#+#+++#+++#+#+++#+++++++#+#+#+++++#+++#+++#+++++#+#
#########+#########+###+#+###+#+#########+#######+#+#+#+#+#+###+#######+###+###+#######+###+#######+#
#+++++++#+++++#+++++++#+#+#+++#+++#+++++++#+++++#+++++#+#+#+++++++++++++#+++#+++#+++++++#+++++++++++#
#+#####+#####+#######+#+#+#+#+###+#+###+###+###+#######+#+###########+###+#+#+###+###################
#+#+++#+++++++#+++#+++++#+#+#+#+++#+#+++#+++++#+++#+++#+#+#+#+++++++#+#+++#+#+#+#+++++#+++++++++++++#
#+#+#+#########+#+#######+#+###+###+#####+#######+#+#+#+#+#+#+#####+###+#####+#+#####+#+###########+#
#+++#+++#+++++++#+++#+++++#+++++++#+++++++#+++++#+++#+#+#+++#+++#+#+++#+#+++++++++#+++#+#+#+++++++#+#
#+#####+#+#########+#+#####+###############+###+#####+#####+###+#+###+#+#+#########+###+#+#+###+###+#
#+++++#+#+#+++#+++++#+#+#+++++++#+++++++++++#+++++++++#+++++#+++#+++#+++#+++#+++++#+#+++#+++++#+++#+#
#######+#+#+#+#+#####+#+#+#####+#+###########+#########+#####+#####+#+#####+#+###+#+#+###########+#+#
#+++++++#+#+#+++#+++++#+++#+++#+#+#+++++#+++++++#+++++++#+++#+++++#+++#+++#+#+#+#+++#+#+++++++++#+#+#
#+#####+#+#+###+#+#####+###+#+###+#+###+#########+#######+#+###+#+#####+#+#+#+#+#+###+#+#######+#+#+#
#+#+++#+#+#+#+++#+#+++#+++#+#+++#+#+++#+++++#+++++#+++++++#+++#+#+++#+++#+#+#+#+++#+++#+++#+++#+++#+#
#+#+#+###+#+#####+#+#+#####+###+#+#+#######+#+#####+#########+#####+#+###+#+#+#####+###+#+#+#+#####+#
#+#+#+#+++#+++#+++#+#+++++#+++#+++#+#+++++++#+++#+++#+++++#+++#+++#+++#+++#+#+++++++#+++#+++#+#+++++#
#+#+#+#+#####+#+###+#####+###+#+###+#+#########+#+#####+#+#+###+#+#####+#+#+#########+#######+#+#####
#+++#+#+#+++#+#+++#+++#+++++++#+#+++#+++++++++++#+++++#+#+++++++#+++++++#+#+++++++++#+#+++++#+#+++++#
#+###+#+###+#+###+###+#+#######+#+###################+#####+#############+#########+###+###+#+#####+#
#+#+++#+#+++#+++#+++#+#+++#+++#+#+++#+++++++++#+++++++#+++#+#+++++++#+++++++#+++++#+++#+++#+++++++#+#
#+#+###+#+#####+###+#+#####+#+#+###+#+#########+#######+#+###+#####+#########+#+#####+###+#########+#
#+#+#+++++#+++#+++#+#+++#+++#+#+++#+#+++++#+++++#+++++++#+++#+#+#+++#+++++++++#+++++#+++++#+++++++++#
###+#+#####+#+#+###+#+#+#+###+###+#+#####+#+#+###+#########+#+#+#+###+###########+#####+###+#########
#+++#+#+++++#+#+#+++#+#+++++#+++#+#+++++++#+#+#+++#+++++#+++#+++#+++#+++#+#+++++++#+++++#+++#+++++++#
#+#+#+#+#####+#+#+#############+#######+###+#+#+###+###+#+###+#####+###+#+#+#+#####+#####+###+#####+#
#+#+#+#+#+++++++#+++++++++++++#+++++++++#+++#+#+#+++++#+#+++++#+++++#+++++#+#+#+++++#+++++#+++#+++#+#
#+###+#+#+###################+#+#########+#####+#####+#+#######+#+###+#####+###+#####+#+###+###+#+#+#
#+++#+#+#+#+++++++++++++++++#+#+++++++#+++#+++#+++++++#+#+++++++#+#+++++#+++#+++#+++++#+#+++++#+#+++#
#+#+#+#+###+#####+###########+#######+#+###+#+#########+#+#+#######+#####+#+#+###+#####+#+#####+###+#
#+#+++#+++++#+++#+++++++++++#+++++#+++#+++++#+#+++++++#+#+#+#+++++++++#+++#+#+#+#+#+++++#+#+#+++#+++#
#+###########+#+###########+#####+###########+#+#####+#+#+###+#########+#####+#+#+#######+#+#+###+###
#+++#+++++++#+#+++++++++++++++++#+++++++++++#+++++#+++#+#+++++++#+#+++#+++++#+++#+++++++#+++#+++#+++#
###+#+#####+#+#############################+#+#####+###+#######+#+#+#+###+#+###+#######+#+#####+###+#
#+#+#+#+++#+++#+++++++++++++++++++++++++#+++#+++#+++#+++#+++#+++#+#+#+++#+#+#+++#+++#+++#+#+++++#+#+#
#+#+#+#+#+###+#+#################+#+#####+#####+#+###+###+#+#+###+#+###+###+#+#####+#+###+#+#####+#+#
#+++#+++#+#+++#+++++#+++++#+++#+++#+#+++++#+++#+#+++#+#+++#+#+++++#+#+++++++#+++++#+#+#+++#+++++#+++#
#########+#########+#+###+#+#+#+###+#+#####+#+#+###+#+#+###+#######+###+#########+#+#+#+#######+###+#
#+++++++++#+++++++++#+++#+++#+++#+++#+++++#+#+#+#+#+++#+#+#+++++++#+++#+#+++++++#+++#+#+++#+++#+++#+#
#+#####+###+###########+#################+#+###+#+#####+#+#######+#+#+###+#+###+###+#+###+#+#+###+#+#
#+++++#+#+++#+++++#+++++#+++++#+++++++++#+#+++++#+++#+++#+++++#+++#+#+++++#+#+++++#+#+++++++#+#+++#+#
#+###+#+#+###+#####+#####+###+#+#######+#+#####+###+#+#######+#+#########+#+#######+###########+#####
#+#+++#+#+#+++++++#+++#+++++#+#+#+++++++#+++++#+#+++#+++++++#+++++++++++#+#+#+++#+++++++#+++#+++#+++#
###+###+#+#######+###+#+#####+#+#+###########+#+#+#########+###########+###+#+#+#+#######+#+#+#+#+#+#
#+++#+++#+++++++++#+#+#+#+++++#+#+++++++++++#+#+#+++++++++#+++++#+++++#+#+++#+#+++++#+++++#+++#+#+#+#
#+###############+#+#+#+#+###+#+###########+#+#+###+#+#####+###+#+###+#+#+###+#######+###+#######+#+#
#+#+++++++#+++++++++#+++#+#+++#+#+++#+++++++#+#+++++#+#+++#+++#+#+#+++#+++#+++#+++++++#+++#+++++#+#+#
#+#+#####+#+#############+#####+###+#+#######+#########+#+###+#+#+#+#######+###+###+#######+###+#+#+#
#+++#+++++#+#+++++#+++++#+++++#+++++#+#+++++#+++++++++++#+++#+#+++#+++++++++++#+#+++#+++++#+#+#+++#+#
#####+#+###+#+###+#+###+#####+#####+#+#+###+###############+#####+#############+#####+###+#+#+#####+#
#+++++#+#+++#+#+++#+++#+++++++#+++#+#+#+++#+++#+++++#+++++#+++++#+++++#+++++++++#+++#+++#+++#+++#+++#
#+#####+#+###+###+###+###+#####+#+#+#+###+###+#+#+#+#####+#####+#+#####+#+#######+#+###+#####+#+#+###
#+#+++#+#+++#+++#+++++#+++#+++++#+#+#+#+++++#+++#+#+++++++++++#+#+#+++++#+#+++#+++#+++++++++++#+#+++#
#+#+#+#####+###+#####+#####+#####+#+#+#+#########+###########+#+#+#+#####+#+#+#+#############+#####+#
#+#+#+#+++++#+++#+++#+#+++++#+++++#+#+#+#+#+++++++#+++++++++#+#+#+#+#+++#+#+#+++#+++++++++++#+#+++++#
#+#+#+#+#####+###+###+#+#####+#####+#+#+#+#+#####+#+#######+#+#+###+#+#+###+#####+#########+###+###+#
#+#+#+#+#+++#+++#+++++#+#+#+++#+++++#+++#+#+#+++++#+#+++++++#+#+++#+++#+++++++#+++#+#+++++#+++#+#+++#
#+#+#+#+###+###+#######+#+#+###+#########+#+#######+#+###########+#############+###+#+###+###+#+#+###
#+++#+++++++++#+++++++++++#+++++++++++++++#+++++++++#+++++++++++++++++++++++++++#+++++++#+++++++#+++e
#####################################################################################################
