#########################################################################################################
s+++#+++#+++++#+++++++#+++++++++++++#+++++++++#+++++++#+++++++#+++++++++++#+++++++++#+++++++++++++++#+++#
###+#+#+#+#+#+###+###+++###+###+++#+#+#+#+###+#++##+###+#+#####+++###+#+#+#+#+#+#+#+#+#+#+########++#+#+#
#+++#+++++#+#+++++#+#+++#+++++#+++#+#+++#+++#+++++++#+++#+#+++++#+++#+++++++++#+++#+#+#+++#+++++++++++#+#
#+####+####+#######+#####+###+###+#+#+#+#+#+++#+++#+++###+#+#######+########+##+###+#+#####+##+##+#+#+###
#+#+++++++++#+++++#+++++++#+++++++#+++++#+#+#+#+++++++++#+++++#+++#+++#+++#+++++++++++++++#+#+++#+++++++#
#+#+#######+##++###+#####+#+###+###+++###+#+++#+######+####+#+#+#+###+++#+###+#####+###+#+#+#+#+#+#####+#
#+++#+++++++++++#+++#+++++#+#+++++#+++#+++++++++++++#+++++#+++++#+++#+#+++++#+#+++#+++++#+++#+#+#+++++++#
######++#####+###+###+#####+#####+#+#+#+++#######+###+#+#+++###+#+#+#+#+###+++#+#+###+#######+++#++####+#
#+++++++++++++#+++#+++#+++++++++++#+++#+#+++++++++++++#+++#+++++++#+#+++++#+#+++++#+++#+++#+++++++++++#+#
#+###+++#+#####+###+#+###+#######+#####+#+#+#+#+#++#+##+#+#####+###########+###+#+#####+#+++###+###+++#+#
#+#+++#+#+++++++#+++#+#+++#+++++++++++#+#+++#+++#+++++++++++++#+#+++++++++#+++++#+#+++++++++#+++++#+#+++#
#+#+###+#+#+#####+#####+#+#+#+###+###+#+#######+#+###+#######+###+###+###+#+#+###+#+#######+#+#+#+++#+###
#+#+#+++++#+++#+++++++#+#+++#+++#+++++++++++#+++++++++++++++#+#+++#+++++#+#+++#+#+#+++#+++++++++++#+#+++#
#+#+#########+#+###+#+#+##+####+#+#########+#####+#########+#+#+#+#+###+#+#+#+#+#+###+#+#+###+#+#+#+###+#
#+#+++++++++++#+++++#+#+++++++++#+++++++++++++++++#+++++#+++#+++++++++++#+#+#+#+#+++++#+++++++++#+#+++++#
#+#+#++#####+##+###+#+#+###+###+#####+#+++####+####++####+###+++#+#######+#+#+#+###+#+#+#######+#+###+###
#+++++++#+++++#+++#+#+#+#+++#+++++++++++#+++++++++#+++++++++#+#+#+++++++#+#+++#+++#+#+#+#+++#+++#+++#+++#
###++##+#+###+###+#+#+++++###+#####+########+####+#######+###+#+#+#####+#++++##+#+#+#+#+#+++++###+#+#+#+#
#+++++++#+#+#+++++++#+++++#+++++++#+#+++++++++++#+++++++++++#+++++++++#+++++++++#+#+++#+#+#+++#+#+#+++#+#
#+#+###+++#+##++###+#####+#+++#+###+#+#######+#+#++#####+##+#++####+#+#+#+#+##+##+#####+#+#####+#+#+###+#
#+#+++++#+#+++++++++++++++#+#+#+#+++#+++#+++#+#+#+++++++++#+++++++++++#+++++#+++#+#+#+++#+#+++++++++++++#
#+###+###+###+###+#+#+#+#####+###++###++#+#+#+#+#+###+###+####++#++##+##+####+#+#+#+#+###+###########++##
#+#+++#+++++#+#+++#+#+#+++++++++++++++++#+#+#+++#+#+++++++#+++++#+++++#+++++++#+#+++++#+#+#+++++++++++++#
#+#+++###+#+++#+#+#+++#+++#+##+####+#####+#+###+#+#+###+###+###+++#######+#####+#####+++#+#++###+##+###+#
#+++++++#+++#+++#+++++#+++#+++++#+++#+++++++++++#+#+#+++#+#+++++#+++#+++++#+#+++#+++#+#+++#+++#+++#+++#+#
#+++###+#+++#+#+#+###+###+#+###+#+###+###+#+#+###+#+#+###+#+#+#####+#+###+#+#+###+++#+#+###+#+++#+##++#+#
#+++#+#+++#+#+#+++#+++++#+++++#+++++++#+++++#+++#+++++++++++#+++++#+++++++++#+++++#+++#+#+++++#+#+++++#+#
#+#+#+#+###+#+#+###+#+#+#####+##++#####+###+#####+#+#+###+#+#####+#########+########+##+###+###+++#####+#
#+#+++#+++++#+#+++++++#+++#+#+#+++++++++#+#+++++#+++++++#+#+++++#+#+++++++++++++++#+++#+++#+#+++#+++#+++#
#+#######+#+#+#+#+#+#+#+#+#+#+#####+++#+#+#####+#+#####+#+##++++#+###+#+#+#+#######+#+###+#+++#+###+###+#
#+++++++#+++#+++#+++++#+++#+#+++#+++++#+++#+++++++++#+++#+#+++++#+#+++#+#+++#+++++++#+++#+++#+#+++#+++#+#
###+#+#+###+#+++#######+#+#+#+#+#++######+#+##++#+#+#+###+++#####+++###+#+###+#+#######+#####+###+#+#+#+#
#+++++#+++++++#+++++++++#+#+++++#+++++++#+#+++++#+++#+++++#+#+++++#+++#+++#+++#+++++++#+++++++#+#+++#+++#
#+#+++###+###+#++####+#+#+#+######+#+##+#######+###+#+##+##+###+###+#+#####+#+#+###+#+##+###+##+#+#+###+#
#+#+++++#+++++++++#+++#+++#+++++++++++++#+++++++++++#+++++#+++#+#+++#+++++++++++#+++++++++++++++++#+++++#
#+#+###+###+#####+#+#+#+#+##+########+###+###+###++#####++###+#+#########+#######+#+##++#######+++++#+###
#+#+++#+++#+++++#+#+++#+++++++++++++++++++++++++#+++#+++++++#+#+++++++++#+++#+++#+++#+++++++++#+++#+++#+#
#+++#####+#+###+#+#+#+#+###+###++##+#+#+#+#####+#+++#+#######+#########+#####+#+#+#+#+#######+#+###+#+#+#
#+++#+++++#+#+++#+#+++#+#+++++#+++++#+#+++++++#+#+#+++#+++++#+#+++++++++#+++++#+++#+++#+++++#+++#+++#+++#
#+###+#####+#+###+#+###+++#+++#+#####+###+###+++#+##++#+#+#+#+#+#+###+###+#####+#+#+#+++#+#+###+#+#+###+#
#+++#+++#+++#+++++#+#+#+++#+++#+++++++++#+#+++#+++#+++#+#+++++#+#+++++#+++++#+++++#+++#+#+#+++++#+#+++#+#
#+#+###+++#+###+#+#+#+#+###+#+#########+###+#######+###+#++##+#+#####+#+###+#+#########+++#+###+#+#####+#
#+++#+++#+++#+#+#+#+#+++#+++#+++++++++#+++++#+++++#+#+++#+++#+#+++++#+++#+++#+++++++++++++#+++++++#+++++#
##++#+###+++#+++#+++++#+#+#######+#+#+#+##+##+#+#+#+#+#####+#+++###+#+###+#####+###+#+###+###+++#+#+#++##
#+++++#+++#+#+#+++#+#+#+++++++++#+#+#+++++++++#+#+++++++++#+++#+++#+++#+++#+++++#+#+#+#+#+++++++#+++#+++#
#+###+###+++#+#####+###+###+##++++#+++##+#+####+#+++#####+#######+#+#+#+###+#####+#+#+#+####+#+##+#####+#
#+++++++#+#+++++++++++++#+++++++#+++#+#+++++++++#+#+#+++#+#+++#+++++++++++#+#+++++#+#+++++#+++++#+#+++++#
####++#+#+#+#+#+#+###++##+###++####+#+#+#+####+##+#+###+#+#+#+##+##+#####+#+#####+#+#+#+#+#+###+#+###+#+#
#+++++#+#+++#+#+++++#+++++#+++++++++++#+++++++++++++++#+#+++#+++++#+++++++++++++#+++++#+++#+++#+++++++#+#
#+#+#+#+###+#+#+#####+##+##+###+++#######+#+####+####+#+#####+###+#########+###+#####+#+++###+#####+###+#
#+#+++++#+++#+#+++#+++#+++++++#+++#+#+++#+#+#+++++++#+++#+++++++++#+++++++++#+++#+++#+#+++++#+#+++++#+++#
#+#######+#######+#+###+#+#+#+###+#+#+#+#+###+#####+###+#+#+##+######+#+++###+###+++###+#+###+#+###+#+###
#+++#+++++++#+++++#+++++++++#+++++++#+#+#+++#+++++#+++++#+++#+++++++#+++++#+++#+++#+++#+#+++++#+++++++++#
#+#+#####+#+#+###########+++###+#####+#+++++#++#++###+#####+###+#+#+###+#+#+###+#+###+#+#+#######+#+###+#
#+#+#+++#+#+++++++++++++#+#+#+++++++++#+#+#+++++++#+++++++#+++++#+#+++++++#+#+++#+++#+++++++++++++#+++++#
#+++#+#+######++#########+###+#+#+#####+#+#+#+##+##+###+#+###+#+++#######+#+#+#####+#+###+#+####+####+#+#
#+#+++#+++++++++++++++++#+#+++#+#+#+#+++#+++#+++++#+++++#+#+++++#+++#+++++++#+#+++++++#+#+++++#+++++#+#+#
#+#+#+####++#+#####+#+#+#+#+#+###+++#+###+#+##+##+#+#####+#+#####+#+###++####+#+##+#++#+#+###+#+++#+#+#+#
#+++#+++++++++#+++#+++#+#+#+#+#+++#+++++#+#+++++#+#+#+++++#+++++++#+++#+++++++#+#+++++++#+++++++++#+++++#
#####+++++###+#+#+#####+#+#+###+#+#####+#+++###+#+###+#+#+#+#####+#+#+#####+#+#+###+#######+#+#+++#+#+++#
#+++++++++#+++#+#+++++#+++++#+++++#+++#+++#+++#+++++++#+#+++#+++#+++#+++++++#+++++#+#+++++#+++++#+++#+#+#
#+++#######+###+#####+##+##+#+###+#+#+#+#+###+#####+###+###+#+#+#+#####+###+###+#+###+++###+#++####+###+#
#+#+#+++++++#+++++#+++#+++#+++#+++++#+++#+++#+#+++++#+#+++++#+#+#+++++++++#+++#+++++++#+++++#+++++++#+++#
#+###+#######+###+#+###+###+#+#+#######+###+#+####++#+#+#+###+#+#########+#+#+#####++########+#+#+###+#+#
#+++++#+#+++++++++++++++#+++#+#+++++#+++++#+#+++++++++++++++++++++++++++++#+#+++++#+++++++++++#+#+++++#+#
#+#++##+++#+#++####++##+#+#+#####+#+#+#+#+#+######+##+###+#+#+#####+#+#+#+++#####+#####+#++######+#####+#
#+#+++#+++#+#+++#+++++++#+++++++++++#+++#+#+++++++++#+++#+++++++++#+++#+#+#+++++#+++#+++++++++#+++++++++#
#+#+#+#+###+###+#####+#+###############+#+#+#######+##++#+++###+###+#####+#####+###+++#+#+###+#+###+#+++#
#+++++#+#+++++#+#+++++#+#+++#+++++#+#+++#+#+++++++++#+++#+++++++#+++++++++#+++#+++++#+++#+++#+#+#+++#+#+#
###+#+#+#####+#+#+++###+#+#+##++++#+#+###+#+#+###+#+#++####+++#+++#+#++####+#+###++######+#+++#+#+###+#+#
#+++++#+++#+++#+++++++++#+#+++++#+++#+#+++++#+++++++++++#+++#+#+++#+++++++++#+++#+++++++++++++#+#+++#+++#
#+##++#+#+#+#+#+#+#+###+#+#+#++##+###+#+###+##++#####+#+#+###+#+###+###########+###########+#+#+###+#+###
#+++++#+++++#+++#+#+++++++#+++++++#+++#+#+++#+++#+++++++#+++#+#+++#+++++#+++++++++++#+++++++++#+++#+++++#
#####+#######+###+++#+#+###+#+###+#+###+#+#+#+###+##+####+#+#+#+#+###+#+#+#+#+#####+#+###+###+###+#####+#
#+#+++#+++++++#+++#+#+++++#+#+++++++#+#+++#+#+#+++#+++++++#+#+++#+#+#+#+++#+#+++++#+#+++#+++++++#+++++++#
#+#+###+#######+###+#####+#+#+#######+#####+#+#+###+#######+###+#+#+++#+###+###+###+#+#+#+#######+#####+#
#+++#+++++++++++#+++#+++++++#+#+++++++++++++#+++#+++++#+++++++++#+#+#+#+++#+#+++#+++++#+++++++#+++++++++#
#++##+###+++++###+#+#######+#+#+###++##+#+###+#+#+###+#+#####+#+#+#+++#+#+#+#####+#+#+###+###+++#+###+###
#+++++++++++++++++#+++++++++#+++#+#+++++++++++#+++++#+#+++++++++++#+++++#+++#+++++#+++#+++#+#+++#+++++#+#
#+######+####+#+#+#########+#+#+#+########+##+#+#####+###+#+#######+###+#+#+#+#+###+###+#+#+#####+#+#+#+#
#+++++++++++#+++#+++++#+++++++#+++++++++++++++++#+++#+++++#+++++++#+++#+++#+#+++++#+++#+#+++#+++#+++#+++#
#+###+###+###########+#+###+#+############+##+++++#+#++##########+#+#+###+#+#####+###+#+#+###+#+#+#+###+#
#+#+++++#+++++++++++++++#+++#+++++++++++#+++++#+#+#+#+++++++++#+#+#+#+++++#+#+++++++++++#+#+++#+++++#+++#
#+#+###+#+###+#####+#++##+#########+##++###+###+#+#+##+######+#+#+###+++#+#+###+###########+#######+++###
#+++#+#+++++#+++#+#+++++#+++#+++++++#+++++++++++#+#+++++#+++++++#+++#+#+#+#+++#+++#+++#+++++#+++++++#+#+#
###+#+#####+###+#+###+++#+#+#+#####+++#+#+#######+#####+#+#+###+###+#+#+#####+#+#+#++##+#####+#+#+#+#+#+#
#+++++++++++#+++#+++#+++#+++#+++#+++++++#+#+++++++++++#+++++++++++++#+#+++++++++#+#+++#+++#+++#+#+++++++#
#+++#+#+#++##+###+#+++###+#####+#########+###+#+#####+###+###+###++##+#++####+#+#+###+++++#+###+###+###+#
#+++#+#+#+++#+++++#+++++#+#+++#+++++#+++#+++++++++++++#+#+++#+++++++#+++++#+++++#+++++#+#+++#+#+++++#+#+#
#+#+#+#####+#+###+#+#####+++#+#####+#+#+#######+#+##+##+#+#+###+###+#+#####+###+#+#+#+#+###+#+#++####+#+#
#+++#+++++#+#+++++#+++#+++#+#+++++++++++++#+++++++++++++++#+++#+++++++++#+++#+++#+++++++++#+#+++++++++#+#
###+###+#+#+###+#+#+#+#+###+#####+#####+#+#+#+#+#######+###++##+#+#+###+#+###+###+#+####++#+#+###+###+#+#
#+#+++#+++#+#+++#+++#+++++++#+++++#+++++#+++#+++#+++++++++#+++++#+++#+++#+#+++#+++++++++++#+++++#+#+++++#
#+###+###+#+++###+++#+###+#+#+##+##+###+#+#######+#+###+#+++###+#+###+###+#+#########+#########+#+#+#####
#+++#+++#+++#+++++++++#+++#+++++++++#+#+#+++#+++#+#+++++#+#+#+++++++++++++++++++++++#+++#+++++#+++#+#+++#
#+#+#+#+###############+###+#+#+#####+++###+++++#+#+#+#+#+#+#+###+#####+#####+##+##+#+#+#+#+#####+#+++#+#
#+#+++++++#+++++++++++++#+++#+++++++#+++++#+#+#+++#+#+#+#+++++++++#+++++#+++++++++++++++++#+++++++#+++#+#
#+##+####+#+#####+#+#+++#+#+#+##+##+#+#####+#+###+++#+#+###+#######+#+###+###+#+##+######+###+#+#######+#
#+#+++++++++++#+++#+++++#+++#+#+++++#+++++++#+++++#+#+#+++++++++++#+++#+++++#+++++++#+#+++++++++++++++++#
#+#+#+#######+#+###+###+###+###+#######+#+###+#+#####+#+###+#####+##++#++########+#+++#+#####+###+###+#+#
#+++#+++++#+++#+#+++++++#+++#+++++++++++#+++++++++++++#+#+++++++#+++++++++#+++#+++++#+++++++++#+++++++#+#
#+++#+###+#####+++###+#+++#+#+###+#######+#+#+#+#++##+#+#+#####+###++######+#+#+###+#+++#+#####+#+#####+#
#+++++#+++++++++++++++#+++++#+++++++++++++++++++++++++#+++++++#+++++++++++++#+++++++++++++++++++#+++++++e
#########################################################################################################
