#############
#+#+#+#++++s#
#+#+++#+###+#
#+++###+++++#
#+#+++++###+#
#+#+###+#+++#
#+#+#+++###+#
#+#+###+#+#+#
#+e+++++++#+#
#############
